WWWWWWWWWWWWWWWWWWWWWWWWWWWWWWWWWWWWWWWWWWWWWWWWWWWW
WWWWWWWWWWWWWWWWWWWWWWWWWWWWWWWWWWWWWWWWWWWWWWWWWWWW
WW          c                ##      t #c         #W
WW WW WW     c      # #          WWWWW#WWcWW#WW WW W
WW WW WW WW WW WWWWW#WWWWWWWW WW WWWWW WW WW WW WW W
WW    #   c    WWWWW          WW #  ### # #   # #  W
WW# ## # WW#WWWWWWWWWWWWWWWWW WWWWWWWW WW WW#WW WW W
WW WW#WWWWW WWWWWWWWWWWWWWWWW WWWWWWWW# c #     WW W
WWT#             #      #     WWWWWWWW#c  # #   #  W
WW WW    #  WWWWWWWWWWWWWWWWWWWWWWWWWW WW WW#WW WW W
WW WW WW WW WWWWWWWWWWW  ## # WWWWW    WW     #  ##W
WW#  ###    WWWWWWWWWWWWWW#WW WWWWW WW  c#      #  W
WW#WW WW WWWWWWWWWWWWWWWWW WW#WWWWW WW WW WWWWW WW W
WW WW WW#WWWWWWWWWWWWWWWWW # #A   # WW WW WW #     W
WW#   WW#  #            WWWWW    c  #   #   ## #   W
WW WW  #             WW WWWWW WWWWWWWW WWWWW WW WW W
WW WWWWW WWWWW WWWWW#WW#WWWWW WWWWWWWW WWWWW    WW W
WW       WWWWW       WWT              # #       ## W
WW WW WWcWWWWW WWWWW#     # c  #     ##WWWWW WW WW W
WW WW WW WWWWW WWWWWWWWWWWWWW WWWWWWWW #      c   #W
WW  #            cWWWWW##                  #       W
WW WW WW WW WW WW WWWWW WWWWWWWW WWWWW WW WW WW WW W
WW WW WW#WW WW WW WWWWW WWWWWWWW WWWWWcWW WW#WW WW W
WW #     ##     #              #  #      # #    #  W
WWWWWWWWWWWWWWWWWWWWWWWWWWWWWWWWWWW #    # #cWWWWWWW
WWWWWWWWWWWWWWWWWWWWWWWWWWWWWWWWWWWWWWWWWWWWWWWWWWWW

