WWWWWWWWWWWWWWWWWWWWWWWWWWWWWWWWWWWWWWWWWWWWWWWWWWWW
WWWWWWWWWWWWWWWWWWWWWWWWWWWWWWWWWWWWWWWWWWWWWWWWWWWW
WW    T   # # ##   # #c    c     c  #    c  # #    W
WW WW WW WW WW WW WW WWWWW WWWWW WW WWWWWWWW WW WW W
WW    WW WW WW WW WW#WWWWW WWWWW WW WWWWWWWW WW#WW W
WW           #       WWWWW##    #    #        #  #cW
WW WW#WW#WW WW WWWWW WWWWWWWWWWW WW#WWWWW WW WW WW W
WW    WW WW    c  WW WWWWWWWWWWW WW WWWWW WW#WW WW W
WW##  #     #  WWWWW  c  c  #  #  ##     #    t    W
WW WW WWWWW WW WWWWWWWWWWWWWWWWWWWWWWWWWW WW WWWWW W
WW   #   c #      WWWWWWWWWWWWWWWWWWWWWWW WW#WWWWW#W
WW         ##                 T    c               W
WW WWWWWWWWWWW WW WWWWWWWWWWWWWWWWWWWWWWW WW#WW WW#W
WW#WWWWWWWWWWW WW  ##      WWWWWWWWWWWWWW WW WW WW W
WW  ##   WWWWW##           c  WWWWWWWW   #     #   W
WW#WW WW WWWWW#WWWWWWWWWWWWWW WWWWWWWW#WW WWWWW WW W
WW WW#WW WWWWW WWWWWWWWWWWWWW WWWWWWWW#WW WWWWW WW W
WW#     #  #   WWWWWWWW          WWWWW           ##W
WW WW#WW WWWWW WWWWWWWW WWWWWWWWWWWWWWWWWcWW WW WW#W
WW#WW WW WWWWW WWWWWWWW WWWWWWWWWWWWWWWWW WW WW WW W
WW   #            # c        #         WWA      # #W
WW#WW WW WW WW WWWWW WWWWWWWWWWWWWWWWW WW WW WW WW#W
WW WW WW WW WW WWWWW WWWWWWWWWWWWWWWWW WW WW#WW WW W
WW    ## ##   #                 # c  #c     #   #  W
WWWWWWWWWWWWWWWWWWWWWWWWWWWWWWWWWWWWWWWWWWWWWWWWWWWW
WWWWWWWWWWWWWWWWWWWWWWWWWWWWWWWWWWWWWWWWWWWWWWWWWWWW

