WWWWWWWWWWWWWWWWWWWWWW
W ##    ## #         W
W # c          W   # W
W    T# #A W       ##W
W   #    # Wc      # W
W    #   #  #    #   W
W   #  # ##    #c    W
W  c   #WWWWWW W    #W
W c          W  t    W
W     W WW#W WWW     W
W          #       # W
WWWWWWWWWWWWWWWWWWWWWW

