WWWWWWWWWWWWWWWWWWWWWWWWWWWWWWWWWWWWWWWWWWWWWWWWWWWW
W #    c  #     WWWWWWWWW     c   #  c   #         W
W  #  WWWW#  WWWWWWWWWWW    WWWW        WW   #     W
W   # WW   WWWWWWWWWWWWWWW  #WWWWW#t  WWWWWW    #  W
W    cW#    WWWWWWWWWWWW    WW#       WWWWWW     #cW
W# c WWWW  ###WWc  WWWWW WWWWWW   WWWWWWWWWWWW #   W
Wc   WWWWWWWW   #  #      WWWWWW WWWWWWWWWWWWWW  T W
W  WWWWWWWWWWWW#  #      #  WWWW   WWWWWWWWWWWW    W
W WWWWWWWWWWWWWWWWWWW W     #         WWWWWWWWWWW  W
W    # c WWWWWWWWWWWWWWWWWWW  #    #    WWWWWWWW   W
WW      WWWWWWWWWWWWWWWWWWWW      WcWW #WWWWWWWW  WW
W    # WWWWWWWWWWWWWWWWWWWWW # WWW      WWWWWWWW   W
W WWW TWWWWWWWWWWWWWWWWWWWWW     W     c        #  W
W      WWWWWWWWWWWWWWWWWWW # WWWWWWWWW     WWWWWWWWW
WWWWWW  WWWWWWWWWWWWWWWWWWWWWWWWWWWWWWWWW cWWWWWWWWW
WW     WWWWWWWWWWWWWWWWWWWWWWWWWWWWWWWW     WWWWWWWW
WW WWWWWWWWWWWWWWWWWWWWWWWWWWWWWWWWWWW    # WWWWWWWW
W  WWWWWWWWWWWWWWWWWWWWWWWWWWWWWWWWWWWWW   WWW WWWWW
WW WWWWWWWWWWWWWWWWWWWWWWWWWWWWWWWWWWWWWW  W     #WW
WW    WWWWWWWWWWWWWWWWWWWWWWWWWWWWWWWWWWWW#        W
WWWWW   WWWWWWWWWWWWWWWWWWWWWWWWWWWWWWWWWWWWW #   cW
WWWWW  WWWWWWWWWWWWWWWWWWWWWWWWWWWWWWWWWWWW c     #W
WWWW   W   WWWWWWWWWWWWWWWWWWWWWWWWWWWWWWW    #    W
WWW#c#   A#    WWWWWWWWWWWWWWWWWWWWWWWW         #  W
W#            #  #                    #  WWWW  #   W
WWWWWWWWWWWWWWWWWWWWWWWWWWWWWWWWWWWWWWWWWWWWWWWWWWWW

