WWWWWWWWWWWWWWWWWWWWWWWWWWWWWWWWWWWWWWWWWWWWWWWWWWWW
WWWWWWWWWWWWWWWWWWWWWWWWWWWWWWWWWWWWWWWWWWWWWWWWWWWW
WW  #    #       ##c#  #             #       #     W
WW WW WW WW WW WW#WW WWWWW WWWWWWWWWWW WW WW WW WW#W
WW WWTWW WW WW WW WW#WWWWW    WWWWWWWW WW WW WW WW W
WW   ## ##     #          c  # c#   #  #    c      W
WW WW WW WWWWW WWWWWWWWWWW#WWWWW WW WWWWW WW WW WW#W
WW WW WW WWWWW WWWWWWWW   # # WW#WW WWWWW WW WW#WW W
WW #  c#          WWWWWWWW WWc c#  ##      #     #cW
WW WWWWW WW WWWWWWWWWWWWWW WW WWWWWWWWWWWWWW#WW WW W
WW WWWWW WW#WWWWWWWWWWWWWW WW WWWWWWWWWWWWWW WW WW W
WW      #     # #      #   WW     #                W
WW WW#WW#WWWWW#WWWWWWWWWWW WW WWWWWWWWWWWWWW WW WW#W
WW#WW WW WWWWW WWWWWWWWWWW WW WWWWWWWWWWWWWW WW WW W
WW #          TWWWWWWWWWWW#  #  c   WW  c      # c#W
WW#WWWWW#WW WW WWWWWWWWWWW#WWWWW WWWWW WWWWW WW WW W
WW WWWWW WW WW WWWWWWWWWWW WWWWW#WWWWW WWWWW WW WW W
WW# # A  c    #    #    #   ##WW#WWWWW  ##    # c##W
WW#WW WWcWWWWW WW WWWWWWWW WW WW WWWWW WW WW WW#WW W
WW WW WW WWWWW#WW WWWWWWWW WW WW WWWWW WW WW WW WW W
WW   #     #    #       WW   #      WW  #   #  #   W
WW WW WW WW WWWWW WW WW#WW WW WW WW WW WW WW WW WW#W
WW WW WW WW WWWWW WW#WW WW WW WW WW WW WW WW WW#WW#W
WW               #  t   ##         #    #  #      cW
WWWWWWWWWWWWWWWWWWWWWWWWWWWWWWWWWWWWWWWWWWWWWWWWWWWW
WWWWWWWWWWWWWWWWWWWWWWWWWWWWWWWWWWWWWWWWWWWWWWWWWWWW

