WWWWWWWWWWWWWWWWWWWWWW
W     c       #T     W
W    W  # c          W
W  #    WW##       t W
W     W W        #   W
W   c   ##  A#       W
W    #        W # #  W
W#     # WW  #       W
W  # # #         #  #W
Wc#  c   WW   W #W  #W
W           #  #     W
WWWWWWWWWWWWWWWWWWWWWW

