WWWWWWWWWWWWWWWWWWWWWWWWWWWWWWWWWWWWWWWWWWWWWWWWWWWW
WWWWWWWWWWWWWWWWWWWWWWWWWWWWWWWWWWWWWWWWWWWWWWWWWWWW
WW#                     #    #     #    #       # #W
WW WW    #c WW WW#WWWWW WW WWWWWcWWWWW WWWWW WW WW W
WW WW WW WW WW WW  ##WW WW#WWWWW WWWWW WWWWW WW WW#W
WW     #    #        #  # #        # #             W
WW WW WW#WW WW WW WW WWWWW WWWWWWWW WWWWWWWWWWW WWWW
WW#WW WW WW WW    WW   # c WW#   WW#    # WWWWWcWWWW
WW ##     ##  c # WWWWWWWW WW WW WW               #W
WW#WW WW WWWWW WWWWWWWWWWW WW WW WWWWW#WWWWWWWWWWWWW
WW WW WW#WW#   WWWWW# #       WW  A #    #WWWWWWWWWW
WW         # #  #   ###    #     WWWWW WWWWWWWWWWWWW
WW WW ##       #        #    ## cT            #    W
WW WW WW#WW WWWWWWWW          #      # c     WW#WWWW
WW   ##  # # # WWWWWWWW  # WW    #   # #   #cc c # W
WW WW WW WW#WWWWWWWWWWWWWW#WW#WWWWWWWW WWWWW#  ## #W
WW WW WW       WWWWWWWWWWW    WWWWWWWW WWWWWWWWWWW W
WW   #  #   WW WWWWW#   t##   WWWWWWWW      #  #   W
WW WW WW WW WW WWWWWWWW WW#WW WWWWWWWW#WWWWW #     W
WW WW WW WW WW      cWW WW WW#WWWWWWWW WWWWW WW WW W
WW         c##c         WW WW#   WWWWW #      ### cW
WW#WW#WWcWW WW#WW#WWWWWWWW WW WWWWWWWW WW #    #   W
WW#WW#WW WW#WW WW    WWWWW WW WWWWWWWW#WW WW WW WW#W
WW  #        #   ## #  #  T      #      #       #  W
WWWWWWWWWWWWWWWWW      #            #     WW #     W
WWWWWWWWWWWWWWWWWWWWWWWWWWWWWWWWWWWWWWWWWWWWWWWWWWWW

