WWWWWWWWWWWWWWWWWWWWWWWWWWWWWWWWWWWWWWWWWWWWWWWWWWWW
WWWWWWWWWWWWWWWWWWWWWWWWWWWWWWWWWWWWWWWWWWWWWWWWWWWW
WW       c        WW#     #             #c # c    #W
WW WW WW WW WWWWWWWWWWW WW#WW WW WW WW WW WW WW WW#W
WW#WW WW WW#WWWWWWWW#  #   # #WW WW WW#WW#WW WW#WW W
WW    c  c  ##    #     WWWWW           #     #   #W
WW#WW WWTWWWWWWWWWWWWWWWWWWWW#WW WWWWW#WWWWW WW WW#W
WW WW WW WWWWWWWWWWWWWWWWW          WW WWWWW#WW WW W
WW# A      # # #     # # #   # #    c   #          W
WW WW WW#WWWWWWWWWWWWWWWWWWWW WW WW#WWWWW WW#WW WW W
WW WW WW WWWWWWWWWWWWWWWWWWWW WW WW WWWWW WW WW WW W
WW   #  #   #   #   #   # c   WW       #       c   W
WW WW WWWWW WW WW#WW WWWWWWWWWWW WWWWWWWWWWWWWWWWW W
WW WWcWWWWW WW WW WW WWWWW#      WWWWWWWWWWWWWWWWW W
WW  # #c WW   cWW#WW          # #       # #   ##  #W
WWWWW#WWWWWWWWWWWWWWWWWWWWWWWWWW WWWWWWWWWWWWWW WW W
WWWWW#WWWWWWWWWWWWWWWWWWWWWWWWWWcWWWWWWWWWWWWWW WW W
WW   #    # WWWWWWWWWWWWWWWWWWWW   c  ##      #   cW
WW WW WW WWWWWWWWWWWWWWWWWWWWWWWWWWWWWWWW WWWWW#WW W
WW WW WW WWWWWWWWWWWWWWWWWWWWWWWWWWWWWWWW WWWWW WW W
WW##         #   #   #     #    #  T#      ##      W
WW WW WW WW WW WWWWWWWWWWWWWWWWWWWWWWWWWW WWWWW WW W
WW WW WW WWcWW#WWWWWWWWWWWWWWWWWWWWWWWWWW WWWWW WW W
WW    #   #    #       t   #   ##    #             W
WWWWWWWWWWWWWWWWWWWWWWWWWWWWWWWWWWWWWWWWWWWWWWWWWWWW
WWWWWWWWWWWWWWWWWWWWWWWWWWWWWWWWWWWWWWWWWWWWWWWWWWWW

