WWWWWWWWWWWWWWWWWWWWWWWWWWWWWWWWWWWWWWWWWWWWWWWWWWWW
WWWWWWWWWWWWWWWWWWWWWWWWWWWWWWWWWWWWWWWWWWWWWWWWWWWW
WW#    #   #   #         #c# #   c##   #    #   WWWW
WW WW WW WW#WW WWWWWWWWWWWWWW WWWWWWWW#WW WWWWW WWWW
WW WW#WW WW WW WWWWWWWWWWW    ##     # WW#WWWWW#WWWW
WW       c      #        c   #  #         ## WW   cW
WW WW#WW WWWWWWWW#WWWWWWWWWWWWWWWWWWWW#WWWWWWWWWWW W
WW WW WW WWWWWWWW WWWWWWWWWWWWWW #  #T WWWWWWWWWWW#W
WW## #  #  #        # T## c       #cWWWWWWWW       W
WW WW WW#WWWWWWWW WWWWWWWWWWWWWW WWWWWWWWWWW WW#WW W
WWcWW WW WWWWWWWW WWWWWWWWWWWWWW WWWWWWWWWWW WW WW#W
WW#c   #          WWWWWWWW#   ##  c   #WWWWW    WW W
WW WW WWWWWWWWWWW WWWWWWWW WW#WW WWWWWWWWWWWWWWWWW W
WW WW WWWWWWWWWWW#WWWWWWWW #     WWWWWWWWWWWWWWWWWcW
WW #       ### #           WW #  WWWWWWWWWWW    # #W
WW WW#WW WWWWWWWW#WW WWWWWWWWWWWWWWWWWWWWWWWWWWtWWWW
WW WW#WW WWWWWWWW WW WWWWWWWWWWWWWWWWWWWWWWWWWW#WWWW
WW   c          c    #  WWWWWWWWWWWWWWWWW  #  A WWWW
WW WW WW WW WW WW#WW WWWWWWWWWWWWWWWWWWWW WW WWWWWWW
WW WW#WW WW WW WW WW#WWWWWWWWWWWWWWWWWWWW#WW WWWWWWW
WW      #     #   WW WWWWWWWWWWWWWWWWW#    ##   WWWW
WW WW WW WWcWW WW WW WWWWWWWWWWWWWWWWWWWWWWWWWW#WWWW
WW WW WW#WW WW WW WW#WWWWWWWWWWWWWWWWWWWWWWWWWW WWWW
WW # #   #    ###   #####   #  #  #      #  #   c  W
WWWWWWWWWWWWWWWWWWWWWWWWWWWWWWWWWWWWWWWWWWWWWWWWWWWW
WWWWWWWWWWWWWWWWWWWWWWWWWWWWWWWWWWWWWWWWWWWWWWWWWWWW

