WWWWWWWWWWWWWWWWWWWWWWWWWWWWWWWWWWWWWWWWWWWWWWWWWWWW
WWWWWWWWWWWWWWWWWWWWWWWWWWWWWWWWWWWWWWWWWWWWWWWWWWWW
WW   #    c    #        #         #    # #         W
WW WW WW WW WW WW WWWWW WWWWWWWW WW   c #    WW WW#W
WW WW WW WW#WW WW WWWWW WWWWWWWW WWWWW WW WW WW WW W
WW #              # #  #WWWWWWWW      #  # #  #    W
WW WW#WW WW WWWWWWWW WW WWWWWWWW WWWWW WWWWW WW WW W
WW WWtWW WWcWWWWWWWW WW    WWWWW WWWWW WWWWW#WWcWW W
WW       #     c  ##  ##WW WWWWW#                # W
WW WW#WWWWWWWWWWW WWWWW WW WWWWWWWW  #       WW WW W
WW WW WWWWWWWWWWW WW  ##WW WWWWWWWW WWWWW WWWWW WW W
WW           c   # # WW#WW WWWWWWWW WW         ####W
WW WWWWWWWWWWW WWWWW WW WW WWWWWWWW     T WW  # WW W
WW WWWWWWWWWWW WWWWWc# #c  WWWWWWWWWWWWWW WW WW WW W
WW     #   #     #      WWWWWWWW      ## # # c  c# W
WW WW WWWWWWWWWWWWWWWWW WWWWWWWW WWWWWWWW   # #    W
WW WW WWWWWWWWWWWWWWWWW  # WWWWW WWWWWWWW WW#WW WW#W
WW  #    A             c     ### WWWWW       #   # W
WW WW WW WWWWWWWWWWWWWWWWW WW#WWWWWWWW WW WW WW## #W
WW#WW WW#WWWWWWWWWWWWWWWWW WW WWWWWWWW WW WW WW#WW W
WW        # #   #   #WWWWW WW #Tc      #       #   W
WW WW#WW WW WWWWW WWWWWWWW WWWWWWWW             WW W
WW#WW WW WW WWWWW#WW  # #     WWWWW WW WW WW WW WW W
WW # #   # c        #   #  #         #      #   #  W
WWWWWWWWWWWWWWWWWWWW# ##   #       cWWWWWWWWc      W
WWWWWWWWWWWWWWWWWWWWWWWWWWWWWWWWWWWWWWWWWWWWWWWWWWWW

