WWWWWWWWWWWWWWWWWWWWWWWWWWWWWWWWWWWWWWWWWWWWWWWWWWWW
WWWWWWWWWWWWWWWWWWWWWWWWWWWWWWWWWWWWWWWWWWWWWWWWWWWW
WW       #     # ##          #T              c #   W
WW WW WW WWWWW WWWWWWWW WWWWW#WW WW WW WW WW#WW WW W
WW          #  WWWWWWWW WWWWW WW#WW WW#WW#WW WW WW W
WW  cc      WW#     #   WWWWW ## #   #       #     W
WW WW WW WWWWW#WWWWWWWWWWWWWWWWW WW#WW WW WW WW#WWcW
WW       #     WWWWWWWWWWW    c  WW WW WW WW WW WW W
WW#     #   WWWWWWWW   c#  #   #   # #  #  #  #    W
WW WWWWWWWWWWWWWWWWWWWW WW WW WWWWWWWWWWW WWWWW#WW W
WW WWWWWWWWWWWWWW#           #WWWWWWWWWWW#WWWWW WWcW
WW    WWWWWWWWWWW WWWWW              #     #      #W
WW WWWWWWWWWWWWWW#WWWWWWWW WWWWW WWWWWWWW WWWWW WW W
WW          WWWWW    WWWWW WWWWW WWWWWWWW WWWWW WW W
WW WWWWW WWWWWWWW WWWWWWWWWWW  ###  WW  #          W
WW WWWWW WWWWWWWW#WWWWWWWWWWWWWWWWW#WW#WW WW#WW WW W
WW WW ## ##       WWWWWWWWWWWWWWWWW WW#WW WW WW WW W
WW#cT #     WWWWWWWWWWWWWWWWWWWW    #         c    W
WW WW WW WW WWWWWWWWWWWWWWWWWWWW WW#WWWWW WW#WW WWcW
WW  # t  WW#WWWWWWWWWWWWWWWWWWWW WW WWWWW WW#WW WW W
WW      #  # # WWWWWWWWWWW ##c# # c   #  A #  #    W
WW WW#WW WWWWW WWWWWWWWWWW WWWWW WW#WW WW#WW WW WW W
WW    #c WWWWW WWWWWWWWWWW WWWWW WW WW WW WW WW WW W
WW    ##   c  #       # c    #    #        #     ##W
WWWWWWWWWWWWWWWWWWWWWWWWWWWWWWWWWWWWWWWWWWWWWWWWWWWW
WWWWWWWWWWWWWWWWWWWWWWWWWWWWWWWWWWWWWWWWWWWWWWWWWWWW

