WWWWWWWWWWWWWWWWWWWWWWWWWWWWWWWWWWWWWWWWWWWWWWWWWWWW
W                      WW#    #c       W           W
W         WWWWWW   #   #   WWWWWWWWWWW W#      #   W
W  ## #WWWWWWWWWWW   WW  WWWWWWWWWWWWW  #    c # # W
W     WWWWWWWWWWWWW  A       WWWWWWWWWWWWWWWWWWc  cW
W      #  #WWWWWWWWWWWWWWWW  WWWWWWWWWWWWWWWWWWWWW W
W   #W   #  WWWWWWWWWWWWWWW WWWWWWWWWW  WWWWWWWW   W
W    WWWWWW  WWWWWWWWWWWWWW  WWWWWWWW  # WWWWWW   cW
W#  WWWWW    WWWWWWWWWWWWWWW #   #WWW W   WWW#     W
W  WWWWW     WWWWWWWWWWWWWWWWWWW      WW    WWW ## W
W   WWWW    #   WWWWWWWWWWWWWWWWWWWWWWWWW#WW #     W
W  WWWWWWWWWW #      #WWWWWWWWWWWWWWWWWWW# Wc      W
W    WWWWWWWWWWW  #c cWWWWWWWWWWWWWWWWWW        WWWW
Wc    WWWWWWWWWWWWWW#WW      #  WWWWWWWWW  WWWWWWWWW
WWW    WWWWWWWWWWWWW W        W    WWWWW WWWWWWWWWWW
W   #WWWWWWWWWWWWWWW      T WWWWW  WWWW     WWWWWWWW
W   WWWWWWWWWWW    W WWW  cWWWWWWW   WWW  W WWWWWWWW
WWW   WWWWWWWWW   #  WWW  WWWWWWWWWW #    W WWWWWWWW
WWWWW #  WWWWWW #  #WWWWWWWWWWWWWWWWWWW     # WWWWWW
WWWWWt#  WWW       WWWWWWWWWWWWWWWWWWWW  # cW#WWWWWW
WWWW    W    #   #  WWWWWWWWWWWWWWWWWWWW# # W  W cWW
W     # W     WWWWWWWWWWWWWWWWWWWWWWWWWWW  #   Wc  W
W         T  WWWWWWWWWWWWWWWWWWWWWWWWWWWW          W
W   #        WWWW   WWWWWWWWWWWWWWWWW   W#         W
W  #    # W     c #                            c  #W
WWWWWWWWWWWWWWWWWWWWWWWWWWWWWWWWWWWWWWWWWWWWWWWWWWWW

