WWWWWWWWWWWWWWWWWWWWWWWWWWWWWWWWWWWWWWWWWWWWWWWWWWWW
WWWWWWWWWWWWWWWWWWWWWWWWWWWWWWWWWWWWWWWWWWWWWWWWWWWW
WW               ##  #  #         # #         ##   W
WW WW WW WWWWW WW WWWWWWWW  c WWWWW WWcWW WW WW WW W
WW#WW WW WWWWW#WW WWWWWWWW WW A##WW WW#WW WW WW WW W
WW##       ##        WWWWW   #  c #         #      W
WW WW#WW WWWWW WW WW WWWWWWWW     #c  #WW WW WWcWW W
WW WW WW WWWWW WW WW WW     #  # WWWWW#WW WW WWcWW W
WW#        # # #t    WW WWWWW#        #       #  # W
WW WW WWWWW WW WW WWWWW#WWWWWWWW WW# # WW WW WWTWW W
WW#WW WWWWW WW WW WWWWW  ##WW       WWWWW WW  #    W
WW  #   c        #   WWWWW WW WWWWW      ###  #   #W
WWWWW WW WW WWWWW WWTWWWWW WW WWWWW #     #  WW WW W
WWWWW WW#WW WWWWW#WW WWWWW    WWWWWWWW#WW  # # c # W
WW c      c  #    WW WWWWW WWWWWWWWWWW WW#WWWWW WW W
WWWWW WW WWWWWWWWWWW WWWWW WWWWWWWWWWW WW     #    W
WWWWW#WW WWWWWWWWWWW WWWWW         #c     WWWWW#WW W
WW# #  c WWWWW             WWWWWWWWWWW#WW   #      W
WW WW   ##                        #  ##WW     ## # W
WW WW WWWWWWWWWWWWWWWWWWWW WW  #      #WW WW WW #  W
WW ##c      WWWWWWWW     #     # WW    #           W
WW WW WWWWW#WWc #  #            #    # # #  #      W
WW WW WWWWW WW WWWWWWWW WW WW WWWWW #  # c   #     W
WW # #                               #             W
WW   #         WWWWWWWWWWW #        # ## # #   #   W
WWWWWWWWWWWWWWWWWWWWWWWWWWWWWWWWWWWWWWWWWWWWWWWWWWWW

